244(E)	/users/bsiranos/projects/phage_fasta/244.fasta
ABCat(E)	/users/bsiranos/projects/phage_fasta/ABCat.fasta
Bask21(E)	/users/bsiranos/projects/phage_fasta/Bask21.fasta
Bruin(E)	/users/bsiranos/projects/phage_fasta/Bruin.fasta
Cactus(E)	/users/bsiranos/projects/phage_fasta/Cactus.fasta
Cjw1(E)	/users/bsiranos/projects/phage_fasta/Cjw1.fasta
Contagion(E)	/users/bsiranos/projects/phage_fasta/Contagion.fasta
Czyszczon1(E)	/users/bsiranos/projects/phage_fasta/Czyszczon1.fasta
DrDrey(E)	/users/bsiranos/projects/phage_fasta/DrDrey.fasta
Dumbo(E)	/users/bsiranos/projects/phage_fasta/Dumbo.fasta
Dusk(E)	/users/bsiranos/projects/phage_fasta/Dusk.fasta
Elph10(E)	/users/bsiranos/projects/phage_fasta/Elph10.fasta
Eureka(E)	/users/bsiranos/projects/phage_fasta/Eureka.fasta
FireRed(E)	/users/bsiranos/projects/phage_fasta/FireRed.fasta
Goku(E)	/users/bsiranos/projects/phage_fasta/Goku.fasta
Henry(E)	/users/bsiranos/projects/phage_fasta/Henry.fasta
Hopey(E)	/users/bsiranos/projects/phage_fasta/Hopey.fasta
HufflyPuff(E)	/users/bsiranos/projects/phage_fasta/HufflyPuff.fasta
Kostya(E)	/users/bsiranos/projects/phage_fasta/Kostya.fasta
Lilac(E)	/users/bsiranos/projects/phage_fasta/Lilac.fasta
MadamMonkfish(E)	/users/bsiranos/projects/phage_fasta/MadamMonkfish.fasta
Mosby(E)	/users/bsiranos/projects/phage_fasta/Mosby.fasta
Murica(E)	/users/bsiranos/projects/phage_fasta/Murica.fasta
Murphy(E)	/users/bsiranos/projects/phage_fasta/Murphy.fasta
Nala(E)	/users/bsiranos/projects/phage_fasta/Nala.fasta
NelitzaMV(E)	/users/bsiranos/projects/phage_fasta/NelitzaMV.fasta
NoSleep(E)	/users/bsiranos/projects/phage_fasta/NoSleep.fasta
OrionPax(E)	/users/bsiranos/projects/phage_fasta/OrionPax.fasta
Pharsalus(E)	/users/bsiranos/projects/phage_fasta/Pharsalus.fasta
PhatBacter(E)	/users/bsiranos/projects/phage_fasta/PhatBacter.fasta
Phaux(E)	/users/bsiranos/projects/phage_fasta/Phaux.fasta
Phrux(E)	/users/bsiranos/projects/phage_fasta/Phrux.fasta
Porky(E)	/users/bsiranos/projects/phage_fasta/Porky.fasta
Pumpkin(E)	/users/bsiranos/projects/phage_fasta/Pumpkin.fasta
Rakim(E)	/users/bsiranos/projects/phage_fasta/Rakim.fasta
RiverMonster(E)	/users/bsiranos/projects/phage_fasta/RiverMonster.fasta
Simpliphy(E)	/users/bsiranos/projects/phage_fasta/Simpliphy.fasta
SirDuracell(E)	/users/bsiranos/projects/phage_fasta/SirDuracell.fasta
Stark(E)	/users/bsiranos/projects/phage_fasta/Stark.fasta
TeardropMSU(E)	/users/bsiranos/projects/phage_fasta/TeardropMSU.fasta
Toto(E)	/users/bsiranos/projects/phage_fasta/Toto.fasta
Tuco(E)	/users/bsiranos/projects/phage_fasta/Tuco.fasta
Ukulele(E)	/users/bsiranos/projects/phage_fasta/Ukulele.fasta
Willez(E)	/users/bsiranos/projects/phage_fasta/Willez.fasta
