Aglet(A3)	/users/bsiranos/projects/phage_fasta/Aglet.fasta
BabyRatchet(A3)	/users/bsiranos/projects/phage_fasta/BabyRatchet.fasta
Bxz2(A3)	/users/bsiranos/projects/phage_fasta/Bxz2.fasta
DaHudson(A3)	/users/bsiranos/projects/phage_fasta/DaHudson.fasta
EpicPhail(A3)	/users/bsiranos/projects/phage_fasta/EpicPhail.fasta
Farber(A3)	/users/bsiranos/projects/phage_fasta/Farber.fasta
GingkoMaracino(A3)	/users/bsiranos/projects/phage_fasta/GingkoMaracino.fasta
Grum1(A3)	/users/bsiranos/projects/phage_fasta/Grum1.fasta
HelDan(A3)	/users/bsiranos/projects/phage_fasta/HelDan.fasta
Hercules11(A3)	/users/bsiranos/projects/phage_fasta/Hercules11.fasta
JHC117(A3)	/users/bsiranos/projects/phage_fasta/JHC117.fasta
Jobu08(A3)	/users/bsiranos/projects/phage_fasta/Jobu08.fasta
Lilith(A3)	/users/bsiranos/projects/phage_fasta/Lilith.fasta
Mainiac(A3)	/users/bsiranos/projects/phage_fasta/Mainiac.fasta
Marie(A3)	/users/bsiranos/projects/phage_fasta/Marie.fasta
MarQuardt(A3)	/users/bsiranos/projects/phage_fasta/MarQuardt.fasta
Methuselah(A3)	/users/bsiranos/projects/phage_fasta/Methuselah.fasta
Microwolf(A3)	/users/bsiranos/projects/phage_fasta/Microwolf.fasta
Misomonster(A3)	/users/bsiranos/projects/phage_fasta/Misomonster.fasta
Norbert(A3)	/users/bsiranos/projects/phage_fasta/Norbert.fasta
Ollie(A3)	/users/bsiranos/projects/phage_fasta/Ollie.fasta
P28Green(A3)	/users/bsiranos/projects/phage_fasta/P28Green.fasta
Phantastic(A3)	/users/bsiranos/projects/phage_fasta/Phantastic.fasta
Phoxy(A3)	/users/bsiranos/projects/phage_fasta/Phoxy.fasta
Pocahontas(A3)	/users/bsiranos/projects/phage_fasta/Pocahontas.fasta
Popcicle(A3)	/users/bsiranos/projects/phage_fasta/Popcicle.fasta
PotatoSplit(A3)	/users/bsiranos/projects/phage_fasta/PotatoSplit.fasta
PurpleHaze(A3)	/users/bsiranos/projects/phage_fasta/PurpleHaze.fasta
QuinnKiro(A3)	/users/bsiranos/projects/phage_fasta/QuinnKiro.fasta
Rockstar(A3)	/users/bsiranos/projects/phage_fasta/Rockstar.fasta
Sabia(A3)	/users/bsiranos/projects/phage_fasta/Sabia.fasta
Spike509(A3)	/users/bsiranos/projects/phage_fasta/Spike509.fasta
Taurus(A3)	/users/bsiranos/projects/phage_fasta/Taurus.fasta
Tiffany(A3)	/users/bsiranos/projects/phage_fasta/Tiffany.fasta
Veracruz(A3)	/users/bsiranos/projects/phage_fasta/Veracruz.fasta
Vix(A3)	/users/bsiranos/projects/phage_fasta/Vix.fasta
Zetzy(A3)	/users/bsiranos/projects/phage_fasta/Zetzy.fasta
